#^.^~****^*~~.~^~..~~~^~.^~.*~**.^^*^*^~..*^^..~^.
*#*~*.~^^^~~.*~*.**.~~^*^**.^~*^^.*^...^..^.**.~^*
^^#**~.*^*^..^**.~~~.~*.~^^~^~^.^~^*~**.~*^.^**.*.
*~~#~^.~*~^~^^*^**.~.*^^*~~^^*~.^.*^^*^.^.~~^^^*~.
*.^~#^.~^.^.^^*~^~~*^..^~^~~^.*^^..**.**~.~~^~*~**
^.^^~#.*~**.*~*^*~^*~~^.^.~.~^**~.^^^^*.~.~~~^^.^.
*~~.*.#~~~^*.^*~~~*^.^**^*^.^.^~~***^^*^.~^^.^^.~.
.~.*~~^#.**.~^^~**^.^.^~~~^.~.^~~^^.~^^.^^~.~.~.*^
.^^^~~*~#^.~.*~.~~..~*~^.~**~..^****~.*~^~~*~**^~^
^^^*^^**.##*.^^*^^^.*~*~^^~*~~.~****~~~~***.^^~~^~
..*^^^^^.^~#^~.^.^^~*~^*~**^*^.~~~*^.^^~**~*~.....
**.^~~~^~*~*#**.**^~.^.*^^^~.^...~.**^^^^~^.~^~.~*
^*~.*.~*^.~.^#^^^*~.**~^.*^*.~~..^~~~*~*^.~~^*^*^^
~*^.^..**~**^#^~***^~~*^*.*~..~^^***^.*~.^*^^^^.~.
*~^~^**^^*^^~^#~^^*~~~*^*~~~~*~^^^*~..~~~~~.*~^~*.
^.*.^*^**^^^~**#*.~^~~~^..~~~*~~^*~..^^.^~*.^~^~**
.***^..*^~~~~^~#*^~~.*.~^.^^*.***^~^.*....~.^.*~^^
^^~~~~.**.*.^^*.#~~^....*~*^~*^^.^~~~^*.~^^^~**^~~
^~~*^*.~.*^^^*^.*#.~*...~**^.^^~.^^.^..^.^**.^^..*
~^***~^.~.~^^^*~~~#*..^~^^.~^.~.**...~^~**~^~~**^~
~~~^~.^*.^*.~*.*~~^#.~*^^~~**.*.*.~^^^..^.~^.*.^~~
^^~...^.*~.^^**~^~*.#^~^~*....^.^^**~.*.^^*..~*~.*
^..^...~.~.*.~***~*~~##.~*~^^~~^~**^~~^*^^~*.~*^*^
*^.**^~*****.~~~..~^~.*##*~^.^^*^..*~^.^.^*.^.~^^*
~...~*^....*^.*^^*...^.~~##^.*~.*~.*^.^*^*^.****^~
^..~***^.*^~~.****.~*^.~.^~#.~^*^~^.****~..~*..*^~
.~^~**~^^..~~~^..*~*.^**~..^#*.~.*..*~~*~.^~.~*~~.
.***~..~**^.~.~.~*.~~**..^.^~#.~*~~~~*.**~~^..^.^^
~.*.~^*^*~^.~*..*~^~~.*.*..*.*#.^~.*~^^*.~^.^~^**^
.*^~^^*.^*.~*...*~~~*.**.~...*.#^.^*.^*~*.^~^**^*.
.~..*....~..~.***~..~^..~~^*^*^~#^~~**^.*~**^**^^*
^.*.~.^.**^*^.~^^*.~..*^~*^***.~*##.^.~~*..^*^~*.~
^~~^~~*.~^^~~^**.^.^^^*^.*^^~~.^.*~#*^^..**..**..^
^.^*.*^..*.~~.^^***^.*~..~.**^*.~^..##^~*.~^~^..~~
~^^.^..*^^.**.~~^*~*^~*~^~~.~*.^~.~*^~#.*..^.^^*^*
^^.~*^~~*.~~*~.^..~*.^.~**.^*^.^~.**.~*#~...~~..*.
.~..^.~.~.^*.~^*~.~.*^*~~*.^.******~*~~*#~~~^.~~*~
~.*..^^*^~*.~~.~.^~..~.~^^^.*~*.**~^*~*^*#^~..^~^^
*.^*^**^*.^^*....**..~^^~.^*^.*~*^**^^..*.#^*^^^.~
^*^~^^*.~*~^*~^~~.*.^*^~*^^~.*~.*~.**.*~^~~#~*^~~*
~~**~*.^.*~..~~^^^~^^^.~***^*.^*~^*~^~*~**..#~..~.
*~**^~~.^.*.~^**~*^^.*^*.^~~*~~~*^.*..~~^*^.#^.^.*
.*^~..*~.*^^^^^~~^^*.~*.~~~.***~^.*..~~*****#~~^*.
.^^..^.^*^~^.~*...**~~~.**^*~~~*^***~^*^~^~~^#^*.*
**.**~.**~.*.*^~~.~^.*^.~~*.^*.~.***~*^^..~*.~#^*^
~..^.****^.****~^~***..^^^^*^.~*^^*.~~.^**^*~^*#~~
^*~^.~*...^^.^~.^^..~^...**...^****^*~*~*^..~^*~#~
...^~^.~^^~~~~.*^~.^~***~~^^^.*^^.~.^*~*~**^***^~#
.~~~~~^^.~~*^.~^^^**~^~.^~^~*..^*~^^*..*~^~**.*.^#
~^**.~**..*^~^^^.^*^~^~*^.~*~.^.**.^.^^.~**^~~^~^#
